..................................................
..................................................
...........##############.........................
.........................................#........
.........................................#........
.........................................#........
.........................................#........
..............#...##############.........#........
.............##..........................#........
.............##...#################......#........
.............##..........................#........
.............##..........................#........
.............##..........................#........
.............##..........................#........
...........#.##..........................#..###...
...........#.##..........................#..###...
...........#.##..........................#..###...
...........#.##..........................#..###...
...........####################..........#..###...
..............#.......#..................#..###...
...........#..#.......#..................#..###...
...........#..#.......##....................###...
...........#..#..#....##....................###...
...........#..#..#....##....................###...
.....########....#....##....................###...
...........#.....#....##....................###...
...........#.....#....##.......################...
...........#.....#....#.....................###...
...........#.....#....#..................#..###...
...........#.....#....#.................##..###...
.................#....#.................##..###...
.................#....#.................##..###...
.................#....#.................##.##.....
.................#....#.................#..##.....
.................#....#....................##.....
.................#.........................##.....
.................#.........................##.....
.................#.........................##.....
.................#.........................##.....
.................#.........................##.....
.................#.........................##.....
.................#.........................##.....
...........................................##.....
...........................................##.....
......................###############......##.....
...........................................##.....
...........................................##.....
...........................................##.....
...........................................##.....
...........................................##.....