..................................................
........................############..............
........................############..............
................................####..............
................................####..............
................................####..............
...............##########.......####..............
................................####..............
................................####..............
................................####..............
................................####..............
................................####.#######.....#
................................######...........#
................................######...........#
.....###########................######...........#
................................######...........#
................................######...........#
................................######...........#
................................######......######
................................######...........#
................................######...........#
................................######...........#
...................................###...........#
...................................###............
###########.......####################............
...................................###.....#......
...................................###.....#......
...................................###.....#......
...................................###.....#......
......................##################...#......
...................................###.#...#......
..................#########........###.#...#......
.......................................#...#......
...........................................#......
...........................................#......
...........................................#......
.#########.................................#......
...........................................#......
..#############............................#......
#..........................................#......
#..........................................#......
#..........................................#......
#..........................................#......
#..........................................#......
#.................................................
#.................................................
#.................................................
#.................................................
..................................................
..................................................