..................................................
............#.....................................
............#.....................................
..####......#.....................................
..####......#.....................................
..####.###############............................
..####......#.....................................
..####......#.....................................
..####......#.........######.................##...
..####......#######..........................##...
..####......#................................##...
#.####......#................................##...
#.####......#.................................#...
#.####......#...............................#.#...
#.####..#...#...............................#.#...
#.####..#...#........#......................#.#...
#.####..#....#################..............#.#...
..####..#............#......................#.#...
..####..#............#......................#.#...
..####..#............#............................
..####..#............#............................
........#............#.....###############........
........#..............................#..........
........#..............................#..........
.......................................#..........
.......................................#..........
.......................................#..........
.......................................#..........
.......................................#..........
.......................................#..........
.......................................#..........
...##############......#...............#..........
.......................#...............#..........
.......................#...............#..........
.......................#...............#..........
...................#####################..........
.......................#...............#..........
.......................#...............#..........
.......................#...............#..........
.......................#..........................
.....#################.#..........................
.......................#..........................
.......................#..........................
.......................#..........................
..................................................
.........########.................................
.........########.................................
.........########.................................
.........########.................................
..................................................