.......................................###########
.......................................###########
.......................................###########
.....................................#...#........
.....................................#...#........
.....................................#...#........
.....................................#...#........
..........................#########..#...#........
..........................#########..#...#........
..........................#########..#...#........
........................#............#...#........
........................#............#...#........
........................#............#...#........
........................#............#...#........
........................#............#...#........
........................#............#...#........
........................#.#..........#...#........
........................#.#..........#...#........
........................#.#..........#...#........
........................#.#..............#........
........................#.#..........#####........
.....#..........################..................
.....#..................#.#.......................
.....#..................#.#.......................
.....#..................#.##......................
.....#..................#.##......................
.....#..................#.##......................
.....#..................#.##.................#....
.....#....................##.................#....
.....#....................##.................#....
.....#.................###########...........#....
.....#.....................#.................#....
.....#.......................................#....
.....#.......................................#....
.............................................#....
................####.........................#....
.............................................#....
.............................................#....
.............................................#....
.............................................#....
.............................................#....
.............................................#....
.............................................#....
......................###############........#....
#############################.....................
#############################.....................
#############################.....................
......................#...........................
......................#...........................
..................................................