.................#######..........................
..................................................
..................................................
...........................#......................
...........................#......................
...........................#......................
..................###########.....................
..................###########.....................
........#.........###########.....................
........#..................#......................
........#..................#......................
........#...............#..#......................
........#...............#..#......................
......#.#...............#..#......................
......#.................#..#......................
......#..........##################...............
......####..............#.........................
......####..............#.........................
......####..............#.........................
......####..............#.........................
......####..............#.........................
......####........##########......................
......####..............#.........................
......####..............#.........................
......####..............#.........................
......####.............#............#########.....
.......................#..........................
..................#############.................#.
..................######........................#.
.......................#........................#.
.......................#........................#.
.......................#........................#.
.......................#........................#.
.......................#........................#.
.......................#........................#.
......##############...#......................#.#.
.......#################......................#.#.
.......#################......................#.#.
...########...................................#.#.
..............................................#.#.
..............................................#.#.
........######................................#.#.
..............................................#.#.
..................#############...............#.#.
..............................................#.#.
..........................###################.#.#.
..............................................#...
..................................................
..................................................
..................................................